//MAP CONVERTED BY dmm2tgm.py THIS HEADER COMMENT PREVENTS RECONVERSION, DO NOT REMOVE
"a" = (
/obj/structure/shuttle/part/bumblebee{
	icon_state = "2,0"
	},
/obj/structure/shuttle/part/bumblebee{
	icon_state = "2,0,1";
	layer = 4.1
	},
/turf/template_noop,
/area/shuttle/escape_pod)
"e" = (
/obj/structure/shuttle/part/bumblebee/opacity_false{
	icon_state = "0,2"
	},
/turf/template_noop,
/area/shuttle/escape_pod)
"h" = (
/obj/structure/shuttle/part/bumblebee/no_dense/opacity_false{
	icon_state = "1,1"
	},
/obj/structure/shuttle/part/bumblebee/no_dense/opacity_false{
	icon_state = "1,1,1";
	layer = 4.1
	},
/obj/structure/machinery/computer/shuttle/escape_pod_panel/bumblebee{
	pixel_x = -32;
	layer = 4.11
	},
/obj/structure/bed/chair/vehicle{
	dir = 8
	},
/turf/open/shuttle/escapepod/floor4,
/area/shuttle/escape_pod)
"o" = (
/obj/structure/shuttle/part/bumblebee/opacity_false,
/obj/structure/shuttle/part/bumblebee/opacity_false{
	icon_state = "0,1,1";
	layer = 4.1
	},
/turf/template_noop,
/area/shuttle/escape_pod)
"p" = (
/obj/structure/shuttle/part/bumblebee{
	icon_state = "2,2"
	},
/turf/template_noop,
/area/shuttle/escape_pod)
"q" = (
/obj/structure/shuttle/part/bumblebee/no_dense/opacity_false{
	icon_state = "3,1"
	},
/obj/structure/bed/chair/vehicle/bumblebee{
	pixel_x = -8;
	pixel_y = 16
	},
/obj/structure/bed/chair/vehicle/bumblebee{
	pixel_x = 8;
	pixel_y = 16
	},
/obj/structure/bed/chair/vehicle/bumblebee{
	dir = 1;
	pixel_x = -8;
	pixel_y = -16
	},
/obj/structure/bed/chair/vehicle/bumblebee{
	dir = 1;
	pixel_x = 8;
	pixel_y = -16
	},
/turf/open/shuttle/escapepod/floor4,
/area/shuttle/escape_pod)
"s" = (
/obj/structure/shuttle/part/bumblebee{
	icon_state = "1,2"
	},
/turf/template_noop,
/area/shuttle/escape_pod)
"t" = (
/obj/structure/shuttle/part/bumblebee{
	icon_state = "3,2"
	},
/turf/template_noop,
/area/shuttle/escape_pod)
"w" = (
/obj/structure/shuttle/part/bumblebee{
	icon_state = "1,0,1";
	layer = 4.1
	},
/turf/template_noop,
/area/shuttle/escape_pod)
"y" = (
/obj/structure/shuttle/part/bumblebee{
	icon_state = "4,2"
	},
/turf/template_noop,
/area/shuttle/escape_pod)
"A" = (
/obj/structure/shuttle/part/bumblebee/no_dense/opacity_false{
	icon_state = "2,1"
	},
/obj/structure/shuttle/part/bumblebee/no_dense/opacity_false{
	icon_state = "2,1,1";
	layer = 4.1
	},
/obj/structure/extinguisher_cabinet/lifeboat{
	pixel_x = 5;
	pixel_y = 13
	},
/turf/open/shuttle/escapepod/floor4,
/area/shuttle/escape_pod)
"C" = (
/obj/structure/shuttle/part/bumblebee/no_dense{
	icon_state = "3,0"
	},
/obj/structure/shuttle/part/bumblebee{
	icon_state = "3,0,1";
	layer = 4.1
	},
/turf/template_noop,
/area/shuttle/escape_pod)
"D" = (
/obj/structure/shuttle/part/bumblebee{
	icon_state = "5,0"
	},
/obj/structure/shuttle/part/bumblebee{
	icon_state = "5,0,1";
	layer = 4.1
	},
/turf/template_noop,
/area/shuttle/escape_pod)
"I" = (
/obj/structure/shuttle/part/bumblebee/opacity_false{
	icon_state = "0,0,1";
	layer = 4.1
	},
/obj/docking_port/mobile/crashable/escape_shuttle/bumblebee_west,
/turf/template_noop,
/area/shuttle/escape_pod)
"K" = (
/obj/structure/shuttle/part/bumblebee/no_dense/opacity_false{
	icon_state = "5,1"
	},
/obj/structure/shuttle/part/bumblebee/no_dense/opacity_false{
	icon_state = "5,1,1";
	layer = 4.1
	},
/obj/structure/machinery/door/airlock/evacuation/bumblebee,
/turf/template_noop,
/area/shuttle/escape_pod)
"L" = (
/obj/structure/shuttle/part/bumblebee/no_dense/opacity_false{
	icon_state = "4,1"
	},
/obj/structure/bed/chair/vehicle/bumblebee{
	pixel_x = -8;
	pixel_y = 16
	},
/obj/structure/bed/chair/vehicle/bumblebee{
	pixel_x = 8;
	pixel_y = 16
	},
/obj/structure/bed/chair/vehicle/bumblebee{
	dir = 1;
	pixel_x = -8;
	pixel_y = -16
	},
/obj/structure/bed/chair/vehicle/bumblebee{
	dir = 1;
	pixel_x = 8;
	pixel_y = -16
	},
/turf/open/shuttle/escapepod/floor4,
/area/shuttle/escape_pod)
"S" = (
/obj/structure/shuttle/part/bumblebee/no_dense{
	icon_state = "4,0"
	},
/obj/structure/shuttle/part/bumblebee{
	icon_state = "4,0,1";
	layer = 4.1
	},
/turf/template_noop,
/area/shuttle/escape_pod)
"T" = (
/obj/structure/shuttle/part/bumblebee{
	icon_state = "5,2"
	},
/turf/template_noop,
/area/shuttle/escape_pod)

(1,1,1) = {"
e
o
I
"}
(2,1,1) = {"
s
h
w
"}
(3,1,1) = {"
p
A
a
"}
(4,1,1) = {"
t
q
C
"}
(5,1,1) = {"
y
L
S
"}
(6,1,1) = {"
T
K
D
"}
