"a" = (/obj/effect/decal/warning_stripes{icon_state = "N"; pixel_y = 1},/turf/open/floor/almayer/edge/smooth/north,/area/oni_digsite/elevator/digsite_elevator{base_lighting_alpha = 255})
"d" = (/obj/docking_port/mobile/digsite_elevator,/turf/closed/wall/unsc/reinforced/hull,/area/oni_digsite/elevator/digsite_elevator{base_lighting_alpha = 255})
"e" = (/obj/effect/decal/warning_stripes{icon_state = "E"; pixel_x = 1},/obj/effect/decal/warning_stripes{icon_state = "S"},/obj/structure/machinery/camera/autoname{dir = 8},/turf/open/floor/almayer/edge/smooth/southeast,/area/oni_digsite/elevator/digsite_elevator{base_lighting_alpha = 255})
"i" = (/obj/effect/decal/warning_stripes{icon_state = "N"; pixel_y = 1},/obj/structure/machinery/computer/shuttle/elevator_controller/digsite_elevator{pixel_y = 35; pixel_x = 2},/turf/open/floor/almayer/edge/smooth/north,/area/oni_digsite/elevator/digsite_elevator{base_lighting_alpha = 255})
"j" = (/obj/effect/decal/warning_stripes{icon_state = "S"},/obj/effect/decal/warning_stripes{icon_state = "W"},/turf/open/floor/almayer/edge/smooth/southwest,/area/oni_digsite/elevator/digsite_elevator{base_lighting_alpha = 255})
"m" = (/obj/effect/decal/warning_stripes{icon_state = "E"; pixel_x = 1},/turf/open/floor/almayer/edge/smooth/east,/area/oni_digsite/elevator/digsite_elevator{base_lighting_alpha = 255})
"o" = (/obj/effect/decal/warning_stripes{icon_state = "W"},/turf/open/floor/almayer/edge/smooth/west,/area/oni_digsite/elevator/digsite_elevator{base_lighting_alpha = 255})
"t" = (/obj/structure/machinery/door/airlock/multi_tile/unsc{id = "digsite"; name = "Elevator Door"},/turf/open/floor/almayer/pod_landing_floor,/area/oni_digsite/elevator/digsite_elevator{base_lighting_alpha = 255})
"x" = (/obj/effect/decal/warning_stripes{icon_state = "N"; pixel_y = 1},/obj/effect/decal/warning_stripes{icon_state = "W"},/obj/structure/machinery/camera/autoname{dir = 4},/turf/open/floor/almayer/edge/smooth/northwest,/area/oni_digsite/elevator/digsite_elevator{base_lighting_alpha = 255})
"A" = (/turf/open/floor/plating/plating_catwalk,/area/oni_digsite/elevator/digsite_elevator{base_lighting_alpha = 255})
"G" = (/turf/closed/wall/unsc/reinforced/hull,/area/oni_digsite/elevator/digsite_elevator{base_lighting_alpha = 255})
"N" = (/obj/effect/decal/warning_stripes{icon_state = "N"; pixel_y = 1},/obj/effect/decal/warning_stripes{icon_state = "E"; pixel_x = 1},/turf/open/floor/almayer/edge/smooth/northeast,/area/oni_digsite/elevator/digsite_elevator{base_lighting_alpha = 255})
"O" = (/obj/effect/decal/warning_stripes{icon_state = "S"},/turf/open/floor/almayer/edge/smooth,/area/oni_digsite/elevator/digsite_elevator{base_lighting_alpha = 255})
"U" = (/turf/open/floor/almayer/pod_landing_floor,/area/oni_digsite/elevator/digsite_elevator{base_lighting_alpha = 255})

(1,1,1) = {"
GGGtUGGG
GxiaaaNG
GoAAAAmG
GoAAAAmG
GjOOOOeG
dGGGGGGG
"}
