"a" = (/obj/structure/shuttle/window,/turf/open/shuttle/dropship/medium_grey_single_wide_left_to_right,/area/mackay_station/elevator/tram_bravo)
"k" = (/turf/closed/shuttle/transit/horizontal,/area/mackay_station/elevator/tram_bravo)
"m" = (/turf/open/shuttle/dropship/medium_grey_single_wide_left_to_right,/area/mackay_station/elevator/tram_bravo)
"s" = (/obj/structure/bed/sofa/vert/grey/top,/turf/open/shuttle/dropship/medium_grey_single_wide_left_to_right,/area/mackay_station/elevator/tram_bravo)
"z" = (/turf/closed/shuttle/transit/tr_corner,/area/mackay_station/elevator/tram_bravo)
"D" = (/obj/structure/machinery/computer/shuttle/elevator_controller/station_tram_bravo{pixel_x = 3; pixel_y = 34},/turf/open/shuttle/dropship/medium_grey_single_wide_left_to_right,/area/mackay_station/elevator/tram_bravo)
"F" = (/obj/docking_port/mobile/station_tram_bravo,/turf/closed/shuttle/transit/bl_corner,/area/mackay_station/elevator/tram_bravo)
"J" = (/obj/structure/machinery/door/airlock/multi_tile/almayer/generic2/glass{id = "bravo"},/turf/open/shuttle/dropship/medium_grey_single_wide_left_to_right,/area/mackay_station/elevator/tram_bravo)
"L" = (/turf/closed/shuttle/transit/tl_corner,/area/mackay_station/elevator/tram_bravo)
"P" = (/turf/closed/shuttle/transit/br_corner,/area/mackay_station/elevator/tram_bravo)
"Y" = (/obj/structure/bed/sofa/vert/grey/bot,/turf/open/shuttle/dropship/medium_grey_single_wide_left_to_right,/area/mackay_station/elevator/tram_bravo)

(1,1,1) = {"
LakJmaz
asDmmsa
aYmmmYa
FaaJmaP
"}
