"a" = (/obj/structure/shuttle/window,/turf/open/shuttle/dropship/medium_grey_single_wide_left_to_right,/area/mackay_station/elevator/tram_romeo)
"k" = (/turf/closed/shuttle/transit/horizontal,/area/mackay_station/elevator/tram_romeo)
"m" = (/turf/open/shuttle/dropship/medium_grey_single_wide_left_to_right,/area/mackay_station/elevator/tram_romeo)
"s" = (/obj/structure/bed/sofa/vert/grey/top,/obj/structure/machinery/computer/shuttle/elevator_controller/station_tram_romeo{pixel_x = 3; pixel_y = 34},/obj/structure/machinery/floodlight/landing/floor{color = "#dae2ff"; light_color = "#dae2ff"},/turf/open/shuttle/dropship/medium_grey_single_wide_left_to_right,/area/mackay_station/elevator/tram_romeo)
"z" = (/turf/closed/shuttle/transit/tr_corner,/area/mackay_station/elevator/tram_romeo)
"D" = (/obj/structure/bed/sofa/vert/grey/top,/obj/structure/machinery/floodlight/landing/floor{color = "#dae2ff"; light_color = "#dae2ff"},/turf/open/shuttle/dropship/medium_grey_single_wide_left_to_right,/area/mackay_station/elevator/tram_romeo)
"F" = (/obj/docking_port/mobile/station_tram_romeo,/turf/closed/shuttle/transit/bl_corner,/area/mackay_station/elevator/tram_romeo)
"J" = (/obj/structure/machinery/door/airlock/multi_tile/almayer/generic2/glass,/turf/open/shuttle/dropship/medium_grey_single_wide_left_to_right,/area/mackay_station/elevator/tram_romeo)
"L" = (/turf/closed/shuttle/transit/tl_corner,/area/mackay_station/elevator/tram_romeo)
"P" = (/turf/closed/shuttle/transit/br_corner,/area/mackay_station/elevator/tram_romeo)
"Y" = (/obj/structure/bed/sofa/vert/grey/bot,/turf/open/shuttle/dropship/medium_grey_single_wide_left_to_right,/area/mackay_station/elevator/tram_romeo)

(1,1,1) = {"
LkJmaz
asmmDa
aYmmYa
FaJmaP
"}
