//MAP CONVERTED BY dmm2tgm.py THIS HEADER COMMENT PREVENTS RECONVERSION, DO NOT REMOVE
"a" = (
/obj/structure/shuttle/window,
/turf/open/shuttle/dropship/medium_grey_single_wide_left_to_right,
/area/mackay_station/elevator/tram_golf)
"k" = (
/turf/closed/shuttle/transit/horizontal,
/area/mackay_station/elevator/tram_golf)
"m" = (
/turf/open/shuttle/dropship/medium_grey_single_wide_left_to_right,
/area/mackay_station/elevator/tram_golf)
"s" = (
/obj/structure/bed/sofa/vert/grey/top,
/turf/open/shuttle/dropship/medium_grey_single_wide_left_to_right,
/area/mackay_station/elevator/tram_golf)
"z" = (
/turf/closed/shuttle/transit/tr_corner,
/area/mackay_station/elevator/tram_golf)
"D" = (
/obj/structure/machinery/computer/shuttle/elevator_controller/station_tram_golf{
	pixel_x = 3;
	pixel_y = 34
	},
/turf/open/shuttle/dropship/medium_grey_single_wide_left_to_right,
/area/mackay_station/elevator/tram_golf)
"F" = (
/obj/docking_port/mobile/station_tram_golf,
/turf/closed/shuttle/transit/bl_corner,
/area/mackay_station/elevator/tram_golf)
"J" = (
/obj/structure/machinery/door/airlock/multi_tile/almayer/generic2/glass{
	id = "golf"
	},
/turf/open/shuttle/dropship/medium_grey_single_wide_left_to_right,
/area/mackay_station/elevator/tram_golf)
"L" = (
/turf/closed/shuttle/transit/tl_corner,
/area/mackay_station/elevator/tram_golf)
"P" = (
/turf/closed/shuttle/transit/br_corner,
/area/mackay_station/elevator/tram_golf)
"Y" = (
/obj/structure/bed/sofa/vert/grey/bot,
/turf/open/shuttle/dropship/medium_grey_single_wide_left_to_right,
/area/mackay_station/elevator/tram_golf)

(1,1,1) = {"
L
a
a
F
"}
(2,1,1) = {"
a
s
Y
a
"}
(3,1,1) = {"
k
D
m
a
"}
(4,1,1) = {"
J
m
m
J
"}
(5,1,1) = {"
m
m
m
m
"}
(6,1,1) = {"
a
s
Y
a
"}
(7,1,1) = {"
z
a
a
P
"}
