//MAP CONVERTED BY dmm2tgm.py THIS HEADER COMMENT PREVENTS RECONVERSION, DO NOT REMOVE
"a" = (
/turf/closed/wall/covenant/lights,
/area/event/metal/dynamic{
	base_lighting_alpha = 0
	})
"c" = (
/turf/open/floor/covenant/endcap/south,
/area/event/metal/dynamic{
	base_lighting_alpha = 0
	})
"d" = (
/turf/open/floor/covenant/paneling/rotated,
/area/event/metal/dynamic{
	base_lighting_alpha = 0
	})
"g" = (
/turf/template_noop,
/area/template_noop)
"h" = (
/turf/open/floor/covenant/smooth_plating/sides/south,
/area/event/metal/dynamic{
	base_lighting_alpha = 0
	})
"i" = (
/turf/open/floor/covenant/smooth_plating/sides/east,
/area/event/metal/dynamic{
	base_lighting_alpha = 0
	})
"l" = (
/turf/open/floor/covenant/lane/vertical,
/area/event/metal/dynamic{
	base_lighting_alpha = 0
	})
"m" = (
/turf/open/floor/covenant/lane/horizontal,
/area/event/metal/dynamic{
	base_lighting_alpha = 0
	})
"o" = (
/turf/open/floor/covenant/smooth_plating/sides/southwest,
/area/event/metal/dynamic{
	base_lighting_alpha = 0
	})
"p" = (
/turf/open/floor/covenant/endcap/north,
/area/event/metal/dynamic{
	base_lighting_alpha = 0
	})
"s" = (
/obj/structure/machinery/recharger/covenant,
/turf/open/floor/covenant/plating,
/area/event/metal/dynamic{
	base_lighting_alpha = 0
	})
"z" = (
/turf/open/floor/covenant/paneling,
/area/event/metal/dynamic{
	base_lighting_alpha = 0
	})
"A" = (
/turf/open/floor/covenant/smooth_plating/sides/southeast,
/area/event/metal/dynamic{
	base_lighting_alpha = 0
	})
"C" = (
/turf/open/floor/covenant,
/area/event/metal/dynamic{
	base_lighting_alpha = 0
	})
"D" = (
/turf/open/floor/covenant/smooth_plating/sides/northwest,
/area/event/metal/dynamic{
	base_lighting_alpha = 0
	})
"F" = (
/turf/open/floor/covenant/smooth_plating/sides/north,
/area/event/metal/dynamic{
	base_lighting_alpha = 0
	})
"N" = (
/turf/open/floor/covenant/smooth_plating/sides/west,
/area/event/metal/dynamic{
	base_lighting_alpha = 0
	})
"O" = (
/turf/open/floor/covenant/smooth_plating/sides/northeast,
/area/event/metal/dynamic{
	base_lighting_alpha = 0
	})
"T" = (
/turf/open/floor/covenant/endcap/east,
/area/event/metal/dynamic{
	base_lighting_alpha = 0
	})
"U" = (
/turf/open/floor/covenant/endcap/west,
/area/event/metal/dynamic{
	base_lighting_alpha = 0
	})

(1,1,1) = {"
g
g
g
g
p
l
l
l
c
g
g
g
g
"}
(2,1,1) = {"
g
g
a
a
C
C
C
C
C
a
a
g
g
"}
(3,1,1) = {"
g
a
a
C
C
D
N
o
C
C
a
a
g
"}
(4,1,1) = {"
g
a
C
D
N
i
i
i
N
o
C
a
g
"}
(5,1,1) = {"
U
C
C
F
A
d
d
d
O
h
C
C
U
"}
(6,1,1) = {"
m
C
D
h
z
a
a
a
z
F
o
C
m
"}
(7,1,1) = {"
m
C
F
h
z
s
a
s
z
F
h
C
m
"}
(8,1,1) = {"
m
C
O
h
z
a
a
a
z
F
A
C
m
"}
(9,1,1) = {"
T
C
C
F
o
d
d
d
D
h
C
C
T
"}
(10,1,1) = {"
g
a
C
O
i
N
N
N
i
A
C
a
g
"}
(11,1,1) = {"
g
a
a
C
C
O
i
A
C
C
a
a
g
"}
(12,1,1) = {"
g
g
a
a
C
C
C
C
C
a
a
g
g
"}
(13,1,1) = {"
g
g
g
g
p
l
l
l
c
g
g
g
g
"}
