//MAP CONVERTED BY dmm2tgm.py THIS HEADER COMMENT PREVENTS RECONVERSION, DO NOT REMOVE
"a" = (
/turf/open/floor/covenant/lane/horizontal,
/area/dark_was_the_night/pod_bay)
"b" = (
/turf/open/floor/covenant/endcap/north,
/area/dark_was_the_night/pod_bay)
"F" = (
/turf/open/floor/covenant/lane/vertical,
/area/dark_was_the_night/pod_bay)
"I" = (
/turf/open/floor/covenant/paneling,
/area/dark_was_the_night/pod_bay)
"L" = (
/turf/open/floor/covenant/endcap/south,
/area/dark_was_the_night/pod_bay)
"U" = (
/turf/closed/wall/covenant/lights/hull/brighter,
/area/dark_was_the_night/pod_bay)
"W" = (
/turf/closed/wall/covenant/hull,
/area/dark_was_the_night/pod_bay)

(1,1,1) = {"
W
W
W
U
W
W
U
W
W
W
"}
(2,1,1) = {"
W
b
F
F
F
F
F
F
L
W
"}
(3,1,1) = {"
U
I
I
I
I
I
I
I
I
a
"}
(4,1,1) = {"
W
b
F
F
F
F
F
F
L
W
"}
(5,1,1) = {"
W
W
W
U
W
W
U
W
W
W
"}
