"a" = (/turf/open/floor/covenant/lane/horizontal,/area/dark_was_the_night/pod_bay)
"b" = (/turf/open/floor/covenant/endcap/north,/area/dark_was_the_night/pod_bay)
"F" = (/turf/open/floor/covenant/lane/vertical,/area/dark_was_the_night/pod_bay)
"I" = (/turf/open/floor/covenant/paneling,/area/dark_was_the_night/pod_bay)
"L" = (/turf/open/floor/covenant/endcap/south,/area/dark_was_the_night/pod_bay)
"U" = (/turf/closed/wall/covenant/lights/hull/brighter,/area/dark_was_the_night/pod_bay)
"W" = (/turf/closed/wall/covenant/hull,/area/dark_was_the_night/pod_bay)

(1,1,1) = {"
WWUWW
WbIbW
WFIFW
UFIFU
WFIFW
WFIFW
UFIFU
WFIFW
WLILW
WWaWW
"}
