//MAP CONVERTED BY dmm2tgm.py THIS HEADER COMMENT PREVENTS RECONVERSION, DO NOT REMOVE
"a" = (
/turf/open/floor/covenant/lane/horizontal,
/area/dark_was_the_night/pod_bay)
"h" = (
/turf/open/floor/covenant/endcap/west,
/area/dark_was_the_night/pod_bay)
"r" = (
/turf/closed/wall/covenant/lights/hull/brighter,
/area/dark_was_the_night/pod_bay)
"E" = (
/turf/open/floor/covenant/lane/vertical,
/area/dark_was_the_night/pod_bay)
"R" = (
/turf/open/floor/covenant/endcap/east,
/area/dark_was_the_night/pod_bay)
"W" = (
/turf/open/floor/covenant/paneling/rotated,
/area/dark_was_the_night/pod_bay)
"Y" = (
/turf/closed/wall/covenant/hull,
/area/dark_was_the_night/pod_bay)

(1,1,1) = {"
Y
Y
E
Y
Y
"}
(2,1,1) = {"
Y
h
W
h
Y
"}
(3,1,1) = {"
Y
a
W
a
Y
"}
(4,1,1) = {"
r
a
W
a
r
"}
(5,1,1) = {"
Y
a
W
a
Y
"}
(6,1,1) = {"
Y
a
W
a
Y
"}
(7,1,1) = {"
r
a
W
a
r
"}
(8,1,1) = {"
Y
a
W
a
Y
"}
(9,1,1) = {"
Y
R
W
R
Y
"}
(10,1,1) = {"
Y
Y
r
Y
Y
"}
