//MAP CONVERTED BY dmm2tgm.py THIS HEADER COMMENT PREVENTS RECONVERSION, DO NOT REMOVE
"a" = (
/turf/open/floor/covenant/smooth_plating/sides/southwest,
/area/template_noop)
"c" = (
/turf/open/floor/covenant/paneling/rotated,
/area/template_noop)
"j" = (
/turf/open/floor/covenant/smooth_plating/sides/northwest,
/area/template_noop)
"p" = (
/turf/closed/wall/covenant/lights/brighter,
/area/template_noop)
"J" = (
/turf/open/floor/covenant/smooth_plating/sides/southeast,
/area/template_noop)
"R" = (
/turf/template_noop,
/area/template_noop)
"S" = (
/turf/open/floor/covenant/paneling,
/area/template_noop)
"Z" = (
/turf/open/floor/covenant/smooth_plating/sides/northeast,
/area/template_noop)

(1,1,1) = {"
R
R
j
p
a
R
R
"}
(2,1,1) = {"
R
j
c
p
c
a
R
"}
(3,1,1) = {"
j
S
p
p
p
S
a
"}
(4,1,1) = {"
p
p
p
p
p
p
p
"}
(5,1,1) = {"
Z
S
p
p
p
S
J
"}
(6,1,1) = {"
R
Z
c
p
c
J
R
"}
(7,1,1) = {"
R
R
Z
p
J
R
R
"}
