//MAP CONVERTED BY dmm2tgm.py THIS HEADER COMMENT PREVENTS RECONVERSION, DO NOT REMOVE
"a" = (
/turf/template_noop,
/area/template_noop)
"f" = (
/turf/closed/wall/covenant/hull,
/area/adminlevel/covenant/no_baselight)
"m" = (
/obj/effect/abstract/ripple/shadow,
/obj/effect/abstract/ripple/shadow,
/turf/template_noop,
/area/adminlevel/covenant/no_baselight)
"u" = (
/turf/closed/wall/covenant/lights/brighter,
/area/adminlevel/covenant/no_baselight)
"v" = (
/turf/open/floor/covenant/paneling,
/area/adminlevel/covenant/no_baselight)
"E" = (
/turf/open/floor/covenant/paneling/rotated,
/area/adminlevel/covenant/no_baselight)
"L" = (
/obj/effect/abstract/ripple/shadow,
/turf/template_noop,
/area/adminlevel/covenant/no_baselight)
"Q" = (
/turf/closed/wall/covenant/hull,
/area/template_noop)

(1,1,1) = {"
a
a
a
a
a
a
a
a
a
a
a
a
a
a
a
a
a
a
a
a
a
a
a
a
a
a
a
a
a
a
a
Q
Q
Q
Q
a
a
"}
(2,1,1) = {"
a
a
a
a
a
a
a
a
a
a
a
a
a
a
a
a
a
a
a
a
a
a
a
a
a
a
a
a
a
a
Q
Q
Q
Q
Q
Q
a
"}
(3,1,1) = {"
a
a
a
a
a
a
a
a
a
a
a
a
a
a
a
a
a
a
a
a
a
a
a
a
a
a
a
a
a
a
a
L
L
m
f
Q
Q
"}
(4,1,1) = {"
a
a
a
a
a
a
a
a
a
a
a
a
a
a
a
a
a
a
a
a
a
a
a
a
a
a
a
a
a
a
a
L
m
m
m
Q
Q
"}
(5,1,1) = {"
a
a
a
a
a
a
a
a
a
a
a
a
a
a
a
a
a
a
a
a
a
a
a
a
a
a
a
a
a
a
L
L
m
m
L
Q
Q
"}
(6,1,1) = {"
a
a
a
a
a
a
a
a
a
a
a
a
a
a
a
a
a
a
a
a
a
a
a
a
a
a
a
a
a
L
L
m
L
L
L
Q
Q
"}
(7,1,1) = {"
a
a
a
a
a
a
a
a
a
a
a
a
a
a
a
a
a
a
a
a
a
a
a
a
a
a
a
a
L
L
m
L
L
a
a
Q
a
"}
(8,1,1) = {"
a
a
a
a
a
a
a
a
a
a
a
a
a
a
a
a
a
a
a
a
a
a
a
a
a
a
a
L
L
m
L
L
a
a
a
a
a
"}
(9,1,1) = {"
a
a
a
a
a
a
a
a
a
a
a
a
a
a
a
a
a
a
a
a
a
a
a
a
a
a
L
L
m
L
L
a
a
a
a
a
a
"}
(10,1,1) = {"
a
a
a
a
a
a
a
a
a
a
a
a
a
a
a
a
a
a
a
a
a
a
a
a
a
L
L
m
L
L
a
a
a
a
a
a
a
"}
(11,1,1) = {"
a
a
a
a
a
a
a
a
a
a
a
a
a
a
a
a
a
a
a
a
a
a
a
a
L
L
m
L
L
a
a
a
a
a
a
a
a
"}
(12,1,1) = {"
a
a
a
a
Q
Q
a
a
a
a
a
a
a
a
a
a
a
a
a
a
a
a
a
L
L
m
L
L
a
a
a
a
a
a
a
a
a
"}
(13,1,1) = {"
a
a
Q
Q
Q
a
a
a
a
a
a
a
a
a
a
a
a
a
L
L
L
L
L
L
m
L
L
a
a
a
a
a
a
a
a
a
a
"}
(14,1,1) = {"
a
Q
Q
Q
L
a
a
a
a
a
a
a
a
a
a
a
a
L
L
m
m
m
L
m
L
L
a
a
a
a
a
a
a
a
a
a
a
"}
(15,1,1) = {"
a
Q
Q
L
L
L
a
a
a
a
a
a
a
a
a
a
L
L
m
f
E
f
m
L
L
a
a
a
a
a
a
a
a
a
a
a
a
"}
(16,1,1) = {"
Q
Q
Q
m
m
L
L
L
L
L
L
L
L
L
L
L
L
m
f
f
u
f
f
m
L
a
a
a
a
a
a
a
a
a
a
a
a
"}
(17,1,1) = {"
Q
Q
Q
m
m
m
m
m
m
m
m
m
m
m
m
m
m
m
v
u
u
u
v
m
L
a
a
a
a
a
a
a
a
a
a
a
a
"}
(18,1,1) = {"
Q
Q
Q
m
m
L
L
L
L
L
L
L
L
L
L
L
L
m
f
f
u
f
f
m
L
a
a
a
a
a
a
a
a
a
a
a
a
"}
(19,1,1) = {"
a
Q
Q
L
L
L
a
a
a
a
a
a
a
a
a
a
L
L
m
f
E
f
m
L
L
a
a
a
a
a
a
a
a
a
a
a
a
"}
(20,1,1) = {"
a
Q
Q
Q
L
a
a
a
a
a
a
a
a
a
a
a
a
L
L
m
m
m
L
m
L
L
a
a
a
a
a
a
a
a
a
a
a
"}
(21,1,1) = {"
a
a
Q
Q
Q
a
a
a
a
a
a
a
a
a
a
a
a
a
L
L
L
L
L
L
m
L
L
a
a
a
a
a
a
a
a
a
a
"}
(22,1,1) = {"
a
a
a
a
Q
Q
a
a
a
a
a
a
a
a
a
a
a
a
a
a
a
a
a
L
L
m
L
L
a
a
a
a
a
a
a
a
a
"}
(23,1,1) = {"
a
a
a
a
a
a
a
a
a
a
a
a
a
a
a
a
a
a
a
a
a
a
a
a
L
L
m
L
L
a
a
a
a
a
a
a
a
"}
(24,1,1) = {"
a
a
a
a
a
a
a
a
a
a
a
a
a
a
a
a
a
a
a
a
a
a
a
a
a
L
L
m
L
L
a
a
a
a
a
a
a
"}
(25,1,1) = {"
a
a
a
a
a
a
a
a
a
a
a
a
a
a
a
a
a
a
a
a
a
a
a
a
a
a
L
L
m
L
L
a
a
a
a
a
a
"}
(26,1,1) = {"
a
a
a
a
a
a
a
a
a
a
a
a
a
a
a
a
a
a
a
a
a
a
a
a
a
a
a
L
L
m
L
L
a
a
a
a
a
"}
(27,1,1) = {"
a
a
a
a
a
a
a
a
a
a
a
a
a
a
a
a
a
a
a
a
a
a
a
a
a
a
a
a
L
L
m
L
L
a
a
Q
a
"}
(28,1,1) = {"
a
a
a
a
a
a
a
a
a
a
a
a
a
a
a
a
a
a
a
a
a
a
a
a
a
a
a
a
a
L
L
m
L
L
L
Q
Q
"}
(29,1,1) = {"
a
a
a
a
a
a
a
a
a
a
a
a
a
a
a
a
a
a
a
a
a
a
a
a
a
a
a
a
a
a
L
L
m
m
L
Q
Q
"}
(30,1,1) = {"
a
a
a
a
a
a
a
a
a
a
a
a
a
a
a
a
a
a
a
a
a
a
a
a
a
a
a
a
a
a
a
L
m
m
m
Q
Q
"}
(31,1,1) = {"
a
a
a
a
a
a
a
a
a
a
a
a
a
a
a
a
a
a
a
a
a
a
a
a
a
a
a
a
a
a
a
L
L
m
Q
Q
Q
"}
(32,1,1) = {"
a
a
a
a
a
a
a
a
a
a
a
a
a
a
a
a
a
a
a
a
a
a
a
a
a
a
a
a
a
a
Q
Q
Q
Q
Q
Q
a
"}
(33,1,1) = {"
a
a
a
a
a
a
a
a
a
a
a
a
a
a
a
a
a
a
a
a
a
a
a
a
a
a
a
a
a
a
a
Q
Q
Q
Q
a
a
"}
