//MAP CONVERTED BY dmm2tgm.py THIS HEADER COMMENT PREVENTS RECONVERSION, DO NOT REMOVE
"a" = (
/turf/closed/wall/covenant/lights,
/area/covenant/no_baselight)
"b" = (
/turf/open/floor/covenant/smooth_plating/sides/north,
/area/covenant/no_baselight)
"e" = (
/turf/open/floor/covenant/lane/horizontal,
/area/covenant/no_baselight)
"f" = (
/obj/structure/machinery/recharger/covenant,
/turf/open/floor/covenant/plating,
/area/covenant/no_baselight)
"j" = (
/turf/open/floor/covenant/endcap/north,
/area/covenant/no_baselight)
"p" = (
/turf/open/floor/covenant/smooth_plating/sides/west,
/area/covenant/no_baselight)
"r" = (
/turf/closed/wall/covenant,
/area/covenant/no_baselight)
"s" = (
/turf/open/floor/covenant/smooth_plating/sides/northeast,
/area/covenant/no_baselight)
"t" = (
/turf/open/floor/covenant/paneling,
/area/covenant/no_baselight)
"z" = (
/turf/open/floor/covenant/smooth_plating/sides/northwest,
/area/covenant/no_baselight)
"A" = (
/turf/open/floor/covenant/smooth_plating/sides/southwest,
/area/covenant/no_baselight)
"C" = (
/turf/open/floor/covenant/smooth_plating/sides/south,
/area/covenant/no_baselight)
"E" = (
/turf/open/floor/covenant/lane/vertical,
/area/covenant/no_baselight)
"G" = (
/turf/open/floor/covenant/smooth_plating/sides/southeast,
/area/covenant/no_baselight)
"H" = (
/turf/open/floor/covenant,
/area/covenant/no_baselight)
"I" = (
/turf/open/floor/covenant/endcap/east,
/area/covenant/no_baselight)
"J" = (
/turf/open/floor/covenant/endcap/south,
/area/covenant/no_baselight)
"L" = (
/turf/open/floor/covenant/smooth_plating/sides/east,
/area/covenant/no_baselight)
"M" = (
/turf/template_noop,
/area/template_noop)
"N" = (
/turf/open/floor/covenant/endcap/west,
/area/covenant/no_baselight)
"P" = (
/turf/open/floor/covenant/paneling/rotated,
/area/covenant/no_baselight)

(1,1,1) = {"
M
M
a
r
M
M
M
M
M
M
M
M
M
M
M
M
M
M
M
M
M
M
M
M
M
M
M
M
M
M
M
r
a
M
M
"}
(2,1,1) = {"
M
z
G
r
r
r
M
M
M
M
M
M
M
M
M
M
M
M
M
M
M
M
M
M
M
M
M
M
M
r
r
r
s
A
M
"}
(3,1,1) = {"
a
G
H
H
a
r
r
r
M
M
M
M
M
M
M
z
E
E
E
A
M
M
M
M
M
M
M
r
r
r
a
H
H
s
a
"}
(4,1,1) = {"
r
r
H
z
G
P
P
r
r
M
M
M
z
E
E
G
H
H
H
s
E
E
A
M
M
M
r
r
P
P
s
A
H
r
r
"}
(5,1,1) = {"
M
r
a
G
H
H
H
t
r
E
E
E
G
H
H
H
H
H
H
H
H
H
s
E
E
E
r
t
H
H
H
s
a
r
M
"}
(6,1,1) = {"
M
r
r
t
H
a
H
t
r
H
H
H
H
H
z
E
E
E
E
L
A
H
H
H
H
H
r
t
H
a
H
t
r
r
M
"}
(7,1,1) = {"
M
M
r
t
H
H
H
t
r
H
H
z
E
E
G
M
M
M
M
M
s
E
E
A
H
H
r
t
H
H
H
t
r
M
M
"}
(8,1,1) = {"
M
M
r
r
P
P
P
r
r
E
E
G
M
M
M
M
M
M
M
M
M
M
M
s
E
E
r
r
P
P
P
r
r
M
M
"}
(9,1,1) = {"
M
M
M
r
r
r
r
r
M
M
M
M
M
M
M
M
M
M
M
M
M
M
M
M
M
M
M
r
r
r
r
r
M
M
M
"}
(10,1,1) = {"
M
M
M
M
e
H
H
e
M
M
M
a
a
M
M
M
M
M
M
M
M
M
a
a
M
M
M
e
H
H
e
M
M
M
M
"}
(11,1,1) = {"
M
M
M
M
e
H
H
e
M
M
a
a
M
M
M
M
M
M
M
M
M
M
M
a
a
M
M
e
H
H
e
M
M
M
M
"}
(12,1,1) = {"
M
M
M
M
e
H
z
G
M
a
a
M
M
M
M
j
E
E
E
J
M
M
M
M
a
a
M
s
A
H
e
M
M
M
M
"}
(13,1,1) = {"
M
M
M
z
G
H
e
M
M
a
M
M
M
a
a
H
H
H
H
H
a
a
M
M
M
a
M
M
e
H
s
A
M
M
M
"}
(14,1,1) = {"
M
M
M
e
H
H
e
M
M
M
M
M
a
a
H
H
z
p
A
H
H
a
a
M
M
M
M
M
e
H
H
e
M
M
M
"}
(15,1,1) = {"
M
M
M
e
H
z
G
M
M
M
M
M
a
H
z
p
L
L
L
p
A
H
a
M
M
M
M
M
s
A
H
e
M
M
M
"}
(16,1,1) = {"
M
M
z
G
H
e
M
M
M
M
M
N
H
H
b
G
P
P
P
s
C
H
H
N
M
M
M
M
M
e
H
s
A
M
M
"}
(17,1,1) = {"
M
M
e
H
H
e
M
M
M
M
M
e
H
z
C
t
a
a
a
t
b
A
H
e
M
M
M
M
M
e
H
H
e
M
M
"}
(18,1,1) = {"
M
M
e
H
H
e
M
M
M
M
M
e
H
b
C
t
f
a
f
t
b
C
H
e
M
M
M
M
M
e
H
H
e
M
M
"}
(19,1,1) = {"
M
M
e
H
H
e
M
M
M
M
M
e
H
s
C
t
a
a
a
t
b
G
H
e
M
M
M
M
M
e
H
H
e
M
M
"}
(20,1,1) = {"
M
M
s
A
H
e
M
M
M
M
M
I
H
H
b
A
P
P
P
z
C
H
H
I
M
M
M
M
M
e
H
z
G
M
M
"}
(21,1,1) = {"
M
M
M
b
H
s
A
M
M
M
M
M
a
H
s
L
p
p
p
L
G
H
a
M
M
M
M
M
z
G
H
e
M
M
M
"}
(22,1,1) = {"
M
M
M
b
H
H
e
M
M
M
M
M
a
a
H
H
s
L
G
H
H
a
a
M
M
M
M
M
e
H
H
e
M
M
M
"}
(23,1,1) = {"
M
M
M
s
A
H
e
M
M
a
M
M
M
a
a
H
H
H
H
H
a
a
M
M
M
a
M
M
e
H
z
G
M
M
M
"}
(24,1,1) = {"
M
M
M
M
e
H
s
A
M
a
a
M
M
M
M
j
E
E
E
J
M
M
M
M
a
a
M
z
G
H
e
M
M
M
M
"}
(25,1,1) = {"
M
M
M
M
e
H
H
e
M
M
a
a
M
M
M
M
M
M
M
M
M
M
M
a
a
M
M
e
H
H
e
M
M
M
M
"}
(26,1,1) = {"
M
M
M
M
e
H
H
e
M
M
M
a
a
M
M
M
M
M
M
M
M
M
a
a
M
M
M
e
H
H
e
M
M
M
M
"}
(27,1,1) = {"
M
M
M
r
r
r
r
r
M
M
M
M
M
M
M
M
M
M
M
M
M
M
M
M
M
M
M
r
r
r
r
r
M
M
M
"}
(28,1,1) = {"
M
M
r
r
P
P
P
r
r
E
E
A
M
M
M
M
M
M
M
M
M
M
M
z
E
E
r
r
P
P
P
r
r
M
M
"}
(29,1,1) = {"
M
M
r
t
H
H
H
t
r
H
H
s
E
E
A
M
M
M
M
M
z
E
E
G
H
H
r
t
H
H
H
t
r
M
M
"}
(30,1,1) = {"
M
r
r
t
H
a
H
t
r
H
H
H
H
H
s
E
E
E
E
E
G
H
H
H
H
H
r
t
H
a
H
t
r
r
M
"}
(31,1,1) = {"
M
r
a
A
H
H
H
t
r
E
E
E
A
H
H
H
H
H
H
H
H
H
z
E
E
E
r
t
H
H
H
z
a
r
M
"}
(32,1,1) = {"
r
r
H
s
A
P
P
r
r
M
M
M
s
L
E
A
H
H
H
z
E
E
G
M
M
M
r
r
P
P
z
G
H
r
r
"}
(33,1,1) = {"
a
A
H
H
a
r
r
r
M
M
M
M
M
M
M
s
E
E
E
G
M
M
M
M
M
M
M
r
r
r
a
H
H
z
a
"}
(34,1,1) = {"
M
s
A
r
r
r
M
M
M
M
M
M
M
M
M
M
M
M
M
M
M
M
M
M
M
M
M
M
M
r
r
r
z
G
M
"}
(35,1,1) = {"
M
M
a
r
M
M
M
M
M
M
M
M
M
M
M
M
M
M
M
M
M
M
M
M
M
M
M
M
M
M
M
r
a
M
M
"}
