//MAP CONVERTED BY dmm2tgm.py THIS HEADER COMMENT PREVENTS RECONVERSION, DO NOT REMOVE
"a" = (
/turf/template_noop,
/area/template_noop)
"b" = (
/obj/structure/prop/invuln/fire,
/turf/template_noop,
/area/template_noop)
"c" = (
/obj/structure/shuttle/part/pelican{
	icon_state = "9,3"
	},
/obj/effect/roof_node/pelican,
/turf/open/shuttle/pelican,
/area/event/metal/dynamic{
	base_lighting_alpha = 0
	})
"d" = (
/obj/structure/shuttle/part/pelican/no_dense{
	icon_state = "1,3";
	pixel_y = -32;
	opacity = 0
	},
/obj/effect/roof_node/pelican,
/obj/effect/decal/cleanable/blood,
/turf/open/shuttle/pelican/paneling/left,
/area/event/metal/dynamic{
	base_lighting_alpha = 0
	})
"e" = (
/obj/structure/shuttle/part/pelican{
	icon_state = "4,1"
	},
/turf/template_noop,
/area/event/metal/dynamic{
	base_lighting_alpha = 0
	})
"f" = (
/obj/effect/roof_node/pelican,
/turf/open/shuttle/pelican/paneling/right,
/area/event/metal/dynamic{
	base_lighting_alpha = 0
	})
"g" = (
/obj/structure/shuttle/part/pelican{
	icon_state = "2,2";
	opacity = 0
	},
/obj/structure/shuttle/part/pelican/no_dense{
	icon_state = "1,2";
	pixel_y = -32;
	opacity = 0
	},
/obj/effect/roof_node/pelican,
/obj/structure/prop/invuln/fire,
/turf/open/shuttle/pelican/directional/east,
/area/event/metal/dynamic{
	base_lighting_alpha = 0
	})
"h" = (
/obj/structure/platform/pelican{
	pixel_x = -4
	},
/obj/effect/roof_node/pelican,
/obj/structure/blocker/invisible_wall/directional{
	dir = 4
	},
/obj/effect/decal/cleanable/blood,
/turf/open/shuttle/pelican/directional/south,
/area/event/metal/dynamic{
	base_lighting_alpha = 0
	})
"i" = (
/obj/structure/shuttle/part/pelican{
	icon_state = "5,1"
	},
/turf/template_noop,
/area/event/metal/dynamic{
	base_lighting_alpha = 0
	})
"j" = (
/obj/structure/gun_rack/halo/medkit{
	pixel_x = -9;
	pixel_y = 25;
	icon_state = "medkit_0";
	initial_stored = 0
	},
/obj/effect/roof_node/pelican,
/turf/open/shuttle/pelican/paneling/left,
/area/event/metal/dynamic{
	base_lighting_alpha = 0
	})
"k" = (
/obj/structure/shuttle/part/pelican{
	icon_state = "12,4";
	opacity = 0
	},
/obj/structure/prop/invuln/fire,
/turf/template_noop,
/area/event/metal/dynamic{
	base_lighting_alpha = 0
	})
"l" = (
/obj/structure/shuttle/part/pelican/no_dense{
	icon_state = "11,3";
	opacity = 0
	},
/obj/structure/machinery/computer/shuttle/dropship/flight/pelican{
	pixel_y = 2;
	density = 1
	},
/obj/effect/roof_node/pelican,
/obj/structure/blocker/invisible_wall/directional{
	dir = 1
	},
/obj/structure/blocker/invisible_wall/directional{
	dir = 8
	},
/obj/structure/shuttle/part/pelican/no_dense{
	icon_state = "11,2";
	opacity = 0;
	pixel_x = -32
	},
/obj/effect/decal/cleanable/blood,
/turf/open/shuttle/pelican/paneling/sideways,
/area/event/metal/dynamic{
	base_lighting_alpha = 0
	})
"m" = (
/obj/structure/shuttle/part/pelican{
	icon_state = "10,2";
	opacity = 0
	},
/turf/template_noop,
/area/event/metal/dynamic{
	base_lighting_alpha = 0
	})
"n" = (
/obj/structure/shuttle/part/pelican/no_dense{
	icon_state = "9,4";
	opacity = 0
	},
/obj/effect/roof_node/pelican,
/obj/structure/prop/invuln/fire,
/turf/open/shuttle/pelican/paneling/smooth,
/area/event/metal/dynamic{
	base_lighting_alpha = 0
	})
"o" = (
/obj/structure/shuttle/part/pelican/no_dense{
	icon_state = "wsmoothe";
	opacity = 0
	},
/obj/structure/bed/chair/dropship/pelican/west{
	pixel_y = 6;
	buckling_y = 3;
	layer = 4;
	non_north_layer = 4
	},
/obj/effect/roof_node/pelican,
/obj/structure/shuttle/part/pelican/directional_density{
	icon_state = "seatslot_e";
	opacity = 0;
	layer = 4.02
	},
/turf/open/shuttle/pelican/directional/west,
/area/event/metal/dynamic{
	base_lighting_alpha = 0
	})
"p" = (
/obj/structure/shuttle/part/pelican{
	icon_state = "8,6"
	},
/obj/structure/prop/invuln/fire,
/turf/template_noop,
/area/event/metal/dynamic{
	base_lighting_alpha = 0
	})
"q" = (
/obj/structure/shuttle/part/pelican{
	icon_state = "6,1"
	},
/turf/template_noop,
/area/event/metal/dynamic{
	base_lighting_alpha = 0
	})
"r" = (
/obj/structure/shuttle/part/pelican/no_dense{
	icon_state = "wsmoothe";
	opacity = 0
	},
/obj/effect/roof_node/pelican,
/obj/structure/bed/chair/dropship/pelican/west{
	pixel_y = 6;
	buckling_y = 3;
	layer = 4.03;
	non_north_layer = 4.03
	},
/obj/structure/shuttle/part/pelican/directional_density{
	icon_state = "seatslot_e";
	opacity = 0;
	layer = 4.05
	},
/obj/effect/decal/cleanable/blood,
/turf/open/shuttle/pelican/directional/west,
/area/event/metal/dynamic{
	base_lighting_alpha = 0
	})
"t" = (
/obj/effect/roof_node/pelican,
/obj/effect/decal/warning_stripes{
	icon_state = "S";
	pixel_y = -4;
	pixel_x = -8
	},
/obj/effect/decal/warning_stripes{
	icon_state = "S";
	pixel_y = -4
	},
/turf/open/shuttle/pelican/paneling/left,
/area/event/metal/dynamic{
	base_lighting_alpha = 0
	})
"u" = (
/obj/structure/shuttle/part/pelican{
	icon_state = "5,6"
	},
/turf/template_noop,
/area/event/metal/dynamic{
	base_lighting_alpha = 0
	})
"v" = (
/obj/structure/shuttle/part/pelican{
	icon_state = "3,1"
	},
/obj/structure/prop/invuln/fire,
/turf/template_noop,
/area/event/metal/dynamic{
	base_lighting_alpha = 0
	})
"w" = (
/obj/structure/shuttle/part/pelican{
	icon_state = "7,1"
	},
/turf/template_noop,
/area/event/metal/dynamic{
	base_lighting_alpha = 0
	})
"x" = (
/obj/structure/shuttle/part/pelican{
	icon_state = "2,5";
	opacity = 0
	},
/obj/structure/shuttle/part/pelican/no_dense{
	icon_state = "1,5";
	pixel_y = -32;
	opacity = 0
	},
/obj/effect/roof_node/pelican,
/turf/open/shuttle/pelican/directional/west,
/area/event/metal/dynamic{
	base_lighting_alpha = 0
	})
"y" = (
/obj/structure/shuttle/part/pelican/no_dense{
	icon_state = "wsmoothw";
	opacity = 0
	},
/obj/effect/roof_node/pelican,
/obj/structure/shuttle/part/pelican/directional_density{
	icon_state = "seatslot_w";
	opacity = 0;
	layer = 4.05
	},
/obj/structure/bed/chair/dropship/pelican/east{
	layer = 4.03;
	non_north_layer = 4.03;
	pixel_y = 6;
	buckling_y = 3
	},
/turf/open/shuttle/pelican/directional/east,
/area/event/metal/dynamic{
	base_lighting_alpha = 0
	})
"z" = (
/obj/structure/shuttle/part/pelican/no_dense{
	icon_state = "wsmoothw";
	opacity = 0
	},
/obj/effect/roof_node/pelican,
/obj/structure/shuttle/part/pelican/directional_density{
	icon_state = "seatslot_w";
	opacity = 0;
	layer = 4.08
	},
/obj/structure/bed/chair/dropship/pelican/east{
	layer = 4.06;
	non_north_layer = 4.06;
	pixel_y = 6;
	buckling_y = 3
	},
/turf/open/shuttle/pelican/directional/east,
/area/event/metal/dynamic{
	base_lighting_alpha = 0
	})
"A" = (
/obj/structure/shuttle/part/pelican{
	icon_state = "2,1"
	},
/obj/structure/shuttle/part/pelican/no_dense{
	icon_state = "1,1";
	pixel_y = -32;
	opacity = 0
	},
/turf/template_noop,
/area/event/metal/dynamic{
	base_lighting_alpha = 0
	})
"B" = (
/obj/structure/shuttle/part/pelican{
	icon_state = "9,5"
	},
/turf/open/floor,
/area/event/metal/dynamic{
	base_lighting_alpha = 0
	})
"C" = (
/obj/structure/shuttle/part/pelican{
	icon_state = "6,6"
	},
/turf/template_noop,
/area/event/metal/dynamic{
	base_lighting_alpha = 0
	})
"D" = (
/obj/effect/roof_node/pelican,
/obj/effect/decal/cleanable/blood{
	icon_state = "gib6"
	},
/turf/open/shuttle/pelican/paneling/right,
/area/event/metal/dynamic{
	base_lighting_alpha = 0
	})
"E" = (
/obj/structure/shuttle/part/pelican{
	icon_state = "3,6"
	},
/turf/template_noop,
/area/event/metal/dynamic{
	base_lighting_alpha = 0
	})
"F" = (
/obj/structure/shuttle/part/pelican{
	icon_state = "7,6"
	},
/turf/template_noop,
/area/event/metal/dynamic{
	base_lighting_alpha = 0
	})
"G" = (
/obj/structure/shuttle/part/pelican{
	icon_state = "2,6"
	},
/obj/structure/shuttle/part/pelican/no_dense{
	icon_state = "1,6";
	pixel_y = -32;
	opacity = 0
	},
/turf/template_noop,
/area/event/metal/dynamic{
	base_lighting_alpha = 0
	})
"H" = (
/obj/structure/shuttle/part/pelican/no_dense{
	icon_state = "wsmoothw";
	opacity = 0
	},
/obj/effect/roof_node/pelican,
/obj/structure/shuttle/part/pelican/directional_density{
	icon_state = "seatslot_w";
	opacity = 0;
	layer = 4.11
	},
/obj/structure/bed/chair/dropship/pelican/east{
	layer = 4.09;
	non_north_layer = 4.09;
	pixel_y = 6;
	buckling_y = 3
	},
/obj/effect/decal/cleanable/blood,
/turf/open/shuttle/pelican/directional/east,
/area/event/metal/dynamic{
	base_lighting_alpha = 0
	})
"I" = (
/obj/structure/shuttle/part/pelican/no_dense{
	icon_state = "wsmoothw";
	opacity = 0
	},
/obj/effect/roof_node/pelican,
/obj/structure/shuttle/part/pelican/directional_density{
	icon_state = "seatslot_w";
	opacity = 0;
	layer = 4.14
	},
/obj/structure/bed/chair/dropship/pelican/east{
	layer = 4.12;
	non_north_layer = 4.12;
	pixel_y = 6;
	buckling_y = 3
	},
/turf/open/shuttle/pelican/directional/east,
/area/event/metal/dynamic{
	base_lighting_alpha = 0
	})
"J" = (
/obj/structure/shuttle/part/pelican{
	icon_state = "12,5";
	opacity = 0
	},
/turf/template_noop,
/area/event/metal/dynamic{
	base_lighting_alpha = 0
	})
"K" = (
/obj/structure/shuttle/part/pelican/no_dense{
	icon_state = "11,4";
	opacity = 0
	},
/obj/structure/bed/chair/dropship/pelican/east{
	pixel_x = -17;
	pixel_y = 4;
	dir = 1;
	north_layer = 4.1;
	layer = 4.1;
	buckling_x = -17;
	buckling_y = 5
	},
/obj/structure/prop/pelican_holotank{
	pixel_x = 4;
	pixel_y = 8
	},
/obj/effect/roof_node/pelican,
/obj/structure/blocker/invisible_wall/directional{
	dir = 4
	},
/obj/structure/blocker/invisible_wall/directional{
	dir = 1
	},
/obj/structure/shuttle/part/pelican/no_dense{
	icon_state = "11,5";
	opacity = 0;
	pixel_x = 32
	},
/obj/effect/decal/cleanable/blood/gibs/body,
/turf/open/shuttle/pelican/paneling/sideways,
/area/event/metal/dynamic{
	base_lighting_alpha = 0
	})
"L" = (
/obj/effect/roof_node/pelican,
/obj/effect/decal/warning_stripes{
	icon_state = "S";
	pixel_y = -4;
	pixel_x = -8
	},
/obj/effect/decal/warning_stripes{
	icon_state = "S";
	pixel_y = -4
	},
/turf/open/shuttle/pelican/paneling/right,
/area/event/metal/dynamic{
	base_lighting_alpha = 0
	})
"M" = (
/obj/structure/shuttle/part/pelican/no_dense{
	icon_state = "wsmoothw";
	opacity = 0
	},
/obj/effect/roof_node/pelican,
/obj/structure/shuttle/part/pelican/directional_density{
	icon_state = "seatslot_w";
	opacity = 0;
	layer = 4.17
	},
/obj/structure/bed/chair/dropship/pelican/east{
	layer = 4.15;
	non_north_layer = 4.15;
	pixel_y = 6;
	buckling_y = 3
	},
/obj/effect/decal/warning_stripes{
	icon_state = "S";
	pixel_y = -4
	},
/turf/open/shuttle/pelican/directional/east,
/area/event/metal/dynamic{
	base_lighting_alpha = 0
	})
"N" = (
/obj/structure/shuttle/part/pelican{
	icon_state = "4,6"
	},
/turf/template_noop,
/area/event/metal/dynamic{
	base_lighting_alpha = 0
	})
"O" = (
/obj/structure/shuttle/part/pelican/no_dense{
	icon_state = "wsmoothe";
	opacity = 0
	},
/obj/effect/roof_node/pelican,
/obj/structure/bed/chair/dropship/pelican/west{
	pixel_y = 6;
	buckling_y = 3;
	layer = 4.15;
	non_north_layer = 4.15
	},
/obj/structure/shuttle/part/pelican/directional_density{
	icon_state = "seatslot_e";
	opacity = 0;
	layer = 4.17
	},
/obj/effect/decal/warning_stripes{
	icon_state = "S";
	pixel_y = -4;
	pixel_x = -8
	},
/turf/open/shuttle/pelican/directional/west,
/area/event/metal/dynamic{
	base_lighting_alpha = 0
	})
"P" = (
/obj/structure/shuttle/part/pelican/no_dense{
	icon_state = "1,3";
	pixel_y = -32;
	opacity = 0
	},
/obj/effect/roof_node/pelican,
/obj/structure/roof/pelican_roof/missing_l_wing,
/turf/open/shuttle/pelican/paneling/right,
/area/event/metal/dynamic{
	base_lighting_alpha = 0
	})
"Q" = (
/obj/effect/roof_node/pelican,
/turf/open/shuttle/pelican/directional/east,
/area/event/metal/dynamic{
	base_lighting_alpha = 0
	})
"R" = (
/obj/effect/roof_node/pelican,
/turf/open/shuttle/pelican/paneling/left,
/area/event/metal/dynamic{
	base_lighting_alpha = 0
	})
"T" = (
/turf/template_noop,
/area/event/metal/dynamic{
	base_lighting_alpha = 0
	})
"U" = (
/obj/effect/roof_node/pelican,
/turf/template_noop,
/area/event/metal/dynamic{
	base_lighting_alpha = 0
	})
"V" = (
/obj/structure/shuttle/part/pelican{
	icon_state = "10,5";
	opacity = 0
	},
/obj/structure/shuttle/part/pelican/no_dense{
	icon_state = "10,6";
	opacity = 0;
	pixel_x = 32
	},
/turf/template_noop,
/area/event/metal/dynamic{
	base_lighting_alpha = 0
	})
"X" = (
/obj/structure/shuttle/part/pelican{
	icon_state = "9,6"
	},
/obj/structure/prop/invuln/fire,
/turf/template_noop,
/area/event/metal/dynamic{
	base_lighting_alpha = 0
	})
"Y" = (
/obj/structure/machinery/computer/dropship_weapons/pelican{
	pixel_x = -2;
	pixel_y = -3;
	layer = 4.44
	},
/obj/structure/bed/chair/dropship/pelican/east{
	dir = 1;
	pixel_y = 5;
	pixel_x = 2;
	north_layer = 4.55;
	layer = 4.65;
	buckling_y = 5;
	buckling_x = 2
	},
/obj/effect/roof_node/pelican,
/obj/structure/blocker/invisible_wall/directional{
	dir = 8
	},
/obj/effect/decal/cleanable/blood,
/turf/open/shuttle/pelican/cockpit_seat,
/area/event/metal/dynamic{
	base_lighting_alpha = 0
	})

(1,1,1) = {"
a
a
a
a
a
a
a
a
a
a
a
a
a
a
a
a
a
a
a
a
a
a
a
a
a
"}
(2,1,1) = {"
a
a
a
a
a
a
a
a
a
a
a
a
a
a
a
a
a
a
a
a
a
a
a
a
a
"}
(3,1,1) = {"
a
a
a
a
a
a
a
a
a
a
a
a
a
a
a
a
a
a
a
a
a
a
a
a
a
"}
(4,1,1) = {"
a
a
a
a
a
a
a
a
a
a
a
a
a
a
a
a
a
a
a
a
a
a
a
a
a
"}
(5,1,1) = {"
a
a
a
a
a
a
a
a
a
a
a
a
a
a
a
a
a
a
a
a
a
a
a
a
a
"}
(6,1,1) = {"
a
a
a
a
a
a
a
a
a
a
a
a
a
a
a
a
a
a
a
a
a
a
a
a
a
"}
(7,1,1) = {"
a
a
a
a
a
a
a
a
a
a
a
a
a
a
a
a
a
a
a
a
a
a
a
a
a
"}
(8,1,1) = {"
a
a
a
a
T
T
w
q
i
e
v
A
a
a
a
a
a
a
a
a
a
a
a
a
a
"}
(9,1,1) = {"
a
a
b
m
T
Q
y
z
H
I
M
g
a
a
a
a
a
a
a
a
a
a
a
a
a
"}
(10,1,1) = {"
a
k
l
Y
c
j
R
R
R
R
t
d
a
a
a
a
a
a
a
a
a
a
a
a
a
"}
(11,1,1) = {"
a
J
K
h
n
f
f
f
U
D
L
P
a
a
a
a
a
a
a
a
a
a
a
a
a
"}
(12,1,1) = {"
a
a
a
V
B
o
r
U
U
U
O
x
a
a
a
a
a
a
a
a
a
a
a
a
a
"}
(13,1,1) = {"
a
a
a
a
X
p
F
C
u
N
E
G
a
a
a
a
a
a
a
a
a
a
a
a
a
"}
(14,1,1) = {"
a
a
a
a
a
a
a
a
a
a
a
a
a
a
a
a
a
a
a
a
a
a
a
a
a
"}
(15,1,1) = {"
a
a
a
a
a
a
a
a
a
a
a
a
a
a
a
a
a
a
a
a
a
a
a
a
a
"}
(16,1,1) = {"
a
a
a
a
a
a
a
a
a
a
a
a
a
a
a
a
a
a
a
a
a
a
a
a
a
"}
(17,1,1) = {"
a
a
a
a
a
a
a
a
a
a
a
a
a
a
a
a
a
a
a
a
a
a
a
a
a
"}
(18,1,1) = {"
a
a
a
a
a
a
a
a
a
a
a
a
a
a
a
a
a
a
a
a
a
a
a
a
a
"}
(19,1,1) = {"
a
a
a
a
a
a
a
a
a
a
a
a
a
a
a
a
a
a
a
a
a
a
a
a
a
"}
(20,1,1) = {"
a
a
a
a
a
a
a
a
a
a
a
a
a
a
a
a
a
a
a
a
a
a
a
a
a
"}
(21,1,1) = {"
a
a
a
a
a
a
a
a
a
a
a
a
a
a
a
a
a
a
a
a
a
a
a
a
a
"}
